111111111111111111111111111111111111111111111111111111111111111111111111
100000000000000000000000000000000000000100000000000001000000000010000001
101000000100000000001000000000000000000000000000000001000000000000000001
100000001000000000000000000000100000000000000000010000000000000000000001
100000000000000001000000001000000000000000000001000000000000000001000001
100000000000000000000000000000000100000000000000000000000000000000000001
100001001001000000000000000000000000000000000000000000100000000000000001
100000000000000100000000001000100000000000100000000000000000000000000001
100000000000000000000001000000000001000000000000000000000000000000000001
110000000000000010000000000000000000000000000000000000000000000000010001
100000000000100000000000000000000000000000000100000000000000000000000001
100000000000000000000000000000000000000000100000000001000000000000000001
100000001010000000000000000000001000001000000000000000000000000000000001
100000000000000000000110000000000000000000000000100000000010000000000001
100000000000000000000000000000000000000000000000000000000000000000000001
100000000000000000100000000000000100000000000010000000100000000000000001
100000000000000000000000000000000100000000000000000000000000000000000001
100000100000000000000010000000000000000000000100000000000000000000000001
100000000000000100000000000000000000000000000000000001000000000000000001
110000000000000000000000000100000000000000000000000000000000000000001001
100001000000000100000000000000000000000000100000000000010000000001000001
100000000000000000000000000000000000000000000000000010000000000000000001
100000000000000000000000000000000000000000000000000000000000000000000001
111111111111111111111111111111111111111111111111111111111111111111111111
1
35
24
36
12

<-- isto são comentários, não vão ser lidos pela aplicação -->

Editar:
<Codigo do mapa>
<Posição de inicio da cobra>
<Posição em X de inicio da cobra>
<Posição em Y de inicio da cobra>
<Posição em X de inicio do bonus>
<Posição em Y de inicio do bonus>