111111111111111111111111111111111111111111111111111111111111111111111111
100000000000000000000000000000000000000000000000000000000000000000000001
100000000000000000000000000000000000000000000000000000000000000000000001
100000000000000000000000000000000000000000000000000000000000000000000001
100000011100000000000000000000000011100000000000000000000000111000000001
100000011100000000000000000000000011100000000000000000000000111000000001
100000011100000000000000000000000011100000000000000000000000111000000001
100000011100000000000000000000000011100000000000000000000000111000000001
100000000000000000000000000000000000000000000000000000000000000000000001
100000000000000000000000000000000000000000000000000000000000000000000001
100000011100000000000000000000000011100000000000000000000000111000000001
100000011100000000000000000000000011100000000000000000000000111000000001
100000011100000000000000000000000011100000000000000000000000111000000001
100000011100000000000000000000000011100000000000000000000000111000000001
100000000000000000000000000000000000000000000000000000000000000000000001
100000000000000000000000000000000000000000000000000000000000000000000001
100000011100000000000000000000000011100000000000000000000000111000000001
100000011100000000000000000000000011100000000000000000000000111000000001
100000011100000000000000000000000011100000000000000000000000111000000001
100000011100000000000000000000000011100000000000000000000000111000000001
100000000000000000000000000000000000000000000000000000000000000000000001
100000000000000000000000000000000000000000000000000000000000000000000001
100000000000000000000000000000000000000000000000000000000000000000000001
111111111111111111111111111111111111111111111111111111111111111111111111
4
1
12
39
13

<-- isto são comentários, não vão ser lidos pela aplicação -->

Editar:
<Codigo do mapa>
<Posição de inicio da cobra>
<Posição em X de inicio da cobra>
<Posição em Y de inicio da cobra>
<Posição em X de inicio do bonus>
<Posição em Y de inicio do bonus>