111111111111111111111111111111111111111111111111111111111111111111111111
100000000000000000000000000000000000000000000000000000000000000000000001
100000000000000000000000000000000000000000000000000000000000000000000001
100000000000000000000000000000000000000000000000000000000000000000000001
100000000000000000000000000000000000000000000000000000000000000000000001
100000000000100000000000000000000000000000000000000000000000100000000001
100000000000100000000000000000000000000000000000000000000000100000000001
100000000000100000000000000000000000000000000000000000000000100000000001
100000000000100000000000000000000000000000000000000000000000100000000001
100000000000100000000000000000000000000000000000000000000000100000000001
100000000000100000000000000000000000000000000000000000000000100000000001
100000000000111111111111111111111111111111111111111111111111100000000001
100000000000111111111111111111111111111111111111111111111111100000000001
100000000000100000000000000000000000000000000000000000000000100000000001
100000000000100000000000000000000000000000000000000000000000100000000001
100000000000100000000000000000000000000000000000000000000000100000000001
100000000000100000000000000000000000000000000000000000000000100000000001
100000000000100000000000000000000000000000000000000000000000100000000001
100000000000100000000000000000000000000000000000000000000000100000000001
100000000000000000000000000000000000000000000000000000000000000000000001
100000000000000000000000000000000000000000000000000000000000000000000001
100000000000000000000000000000000000000000000000000000000000000000000001
100000000000000000000000000000000000000000000000000000000000000000000001
111111111111111111111111111111111111111111111111111111111111111111111111
4
1
12
2
13

<-- isto são comentários, não vão ser lidos pela aplicação -->

Editar:
<Codigo do mapa>
<Posição de inicio da cobra>
<Posição em X de inicio da cobra>
<Posição em Y de inicio da cobra>
<Posição em X de inicio do bonus>
<Posição em Y de inicio do bonus>