111111111111111111111111111111111111111111111111111111111111111111111111
100000000000000000000000000000000000000000000000000000000000000000000001
100000000000000000000000000000000000000000000000000000000000000000000001
100000000000000000000000000010000000000000000100000000000000000000000001
100000000000000000000000000010000000000000000100000000000000000000000001
100000000000000000000000000010000000000000000100000000000000000000000001
100000000000000000000000000010000000000000000100000000000000000000000001
100000000000000000000000000010000000000000000100000000000000000000000001
100000000000000000000000000010000000000000000100000000000000000000000001
100000000000000000000000000010000000000000000100000000000000000000000001
100000000000000000000000000000000000000000000000000000000000000000000001
100000000000000000000000000000000000000000000000000000000000000000000001
100000000000000000000000000000000000000000000000000000000000000000000001
100000000000000000000000000010000000000000000100000000000000000000000001
100000000000000000000000000010000000000000000100000000000000000000000001
100000000000000000000000000010000000000000000100000000000000000000000001
100000000000000000000000000010000000000000000100000000000000000000000001
100000000000000000000000000010000000000000000100000000000000000000000001
100000000000000000000000000010000000000000000100000000000000000000000001
100000000000000000000000000010000000000000000100000000000000000000000001
100000000000000000000000000010000000000000000100000000000000000000000001
100000000000000000000000000000000000000000000000000000000000000000000001
100000000000000000000000000000000000000000000000000000000000000000000001
111111111111111111111111111111111111111111111111111111111111111111111111
3
35
1
36
12

<-- isto são comentários, não vão ser lidos pela aplicação -->

Editar:
<Codigo do mapa>
<Posição de inicio da cobra>
<Posição em X de inicio da cobra>
<Posição em Y de inicio da cobra>
<Posição em X de inicio do bonus>
<Posição em Y de inicio do bonus>